NO ./assets/mandatory/NO.xpm
SO ./assets/mandatory/SO.xpm
EA ./assets/mandatory/EA.xpm
WE ./assets/mandatory/WE.xpm
C 5,5,45
F 30,5,5

11111111111111111111111111111111111111111111111111111111111111
10000000000000000000000000000000000000000000000000000000000001
10000000011111111111111111111111111111111111111111111111111111
1000000001
10N0000001
1011111111
101
101
101
101
101
101
101
101
101
101
101
101
101
101
101
101
101
101
101
101
101
101
111
