NO ./assets/mandatory/NO.xpm
SO ./assets/mandatory/SO.xpm
EA ./assets/mandatory/EA.xpm
WE ./assets/mandatory/WE.xpm
C 5,5,45
F 30,5,5

1111111111               1111111111
1000000001               1000000001
1000000001               1000000001
1000000001               1000000001
1000000001               1000000001
111111001                 100111111
     1001                 1001
     1001111111111111111111001
     1000000000000000000000001
     1001111111111111111111001
     1001                 1001
111111001                 100111111
1W00000001               1000000001
1000000001               1000000001
1000100001               1000000001
1000010001               1000000001
1111111111               1111111111
