NO ./assets/bonus/NO.xpm
SO ./assets/bonus/SO.xpm
EA ./assets/bonus/EA.xpm
WE ./assets/bonus/WE.xpm
DO ./assets/bonus/door.xpm
C 5,5,45
F 30,5,5

1111111111               1111111111       111111111
100D000001               1000000001       100000001
1001111111               1000000001       100000001
1000000001               1000000001       100010001
1000000001               1000000001       100000001
111111001                 100001111       100000001
     1001                 10001           100000001
     10011111111111111111111D111111111111110000000111111111
     100D00000000D00000000D000D00000000000D0000000D000000001
     10011111111111111111111D111111111111110000000111111111
     1001                 10001           100000001
111111001                 100001111       100000001
1000000001               1000000001       100000001
1000000001               1000000001       100010001
1000000001               1000000001       100000001
1000000001               1000000001       100000001
1111111D1                1111111111       111111111
      101
      101
      101
1111111D1                1111111111       111111111
1000000001               1000000001       100000001                            1
1000000001               1000000001       100000001                           101
1000000001               1000000001       100010001                          10001
1000000001               1000000001       100000001                         1000001
111111001                 100001111       100000001                        100000001
     1001                 11001           100000001                       10000000001
     10011111111111111111111D111111111111110000000111111111              10000000001
     100D00000000D00000000D000D00000000000D0000000D000000001              10000000001
     10011111111111111111111D11111111111111000000011111110001            10000000001
     1001                 10001           100000001      10001            10000000001
111111001                 100001111       100000001       10001          10000000001
1000000001               1000000001       100000001        10001          10000000001
1000000001               1000000001       100010001         10001        10000000001
1001111111               1000000001       100000001          10001        10000000001
100D000001               1000000001       100000001           10001      10000000001
1111111D11               1111111111       111111111            10001      10000000001
      101                                                       10001    10000000001
      101                                                        1D111111110000000001
      101                                                        10000000D000W000001
      101                                                        1D111111110000000001
      101                                                       10001    10000000001
1111111D1                1111111111       111111111            10001      10000000001
100D000001               1000000001       100000001           10001      10000000001
1001111111               1000000001       100000001          10001        10000000001
1000000001               1000000001       100010001         10001        10000000001
1000000001               1000000001       100000001        10001          10000000001
111111001                 100001111       100000001       10001          10000000001
     1001                 10001           100000001      10001            10000000001
     10011111111111111111111D11111111111111000000011111110001            10000000001
     100D00000000D00000000D000D00000000000D0000000D000000001              10000000001
     10011111111111111111111D111111111111110000000111111111              10000000001
     1001                 10001           100000001                       10000000001
111111001                 100001111       100000001                        100000001
1000000001               1000000001       100000001                         1000001
1000000001               1000000001       100010001                          10001
1000000001               1000000001       100000001                           101
1000000001               1000000001       100000001                            1
1111111D1                1111111111       111111111
      101
      101
      101
1111111D1                1111111111       111111111
100D000001               1000000001       100000001
1001111111               1000000001       100000001
1000000001               1000000001       100010001
1000000001               1000000001       100000001
111111001                 100001111       100000001
     1001                 10001           100000001
     10011111111111111111111D111111111111110000000111111111
     100D00000000D00000000D000D00000000000D0000000D000000001
     10011111111111111111111D111111111111110000000111111111
     1001                 10001           100000001
111111001                 100001111       100000001
1000000001               1000000001       100000001
1000000001               1000000001       100010001
1000000001               1000000001       100000001
1000000001               1000000001       100000001
1111111111               1111111111       111111111
